R 960 480

NO ./textures/1.xpm
SO ./textures/178.xpm
EA ./textures/33.xpm
WE ./textures/193.xpm

S ./sprites/446.xpm

F 100,100,100
C 150,150,150

111111
1N0101
102001
111111