R 960 480

NO ./textures/1.xpm
SO ./textures/178.xpm
EA ./textures/33.xpm
WE ./textures/193.xpm

S ./sprites/446.xpm

F 100,100,100
C 150,150,150

	     1		1
        1111111111111111111111111111111
        1000002000110000000000000000001
        1011000001110000200000001111111
        1001000000000000000000001
111111111011000001110000000000001
100000000011000001110111111111111
11110111111111011100000010001
11110111111111011101010012221
11000000110101011100000010001
10002000200020000000000000001
12000000000000001101010010001
11000000110101011111011110N0111
110101101 110101 101111110001
110111101 111111  1     1111111111111
 101  101
 101  101
 101  101
 101  111
 111
