R 960 480

NO ./textures/1.xpm
SO ./textures/178.xpm
EA ./textures/33.xpm
WE ./textures/193.xpm

S ./sprites/446.xpm

F 100,100,100
C 150,150,150

          111111     11
    111111111111111111111111
    110000000011000000021111
11111000011120000S0000021
1001000000000000000000021
1011000001110000000000021
1000000000110000011101111
1111011111111111110000001
1111011111111111110000001111
1111011111110001110000021
1111011000000000110000001
1200000000000000110000001
1111000011000001111101011
    1100011110110001010111111
    1100011110110001010011111
1111000111110001110000011
10000000111000011100001111
1020000011100001110000111
1000000011100001110000111
1000000000000000000000011
1020000000000000000002001
1001000000000100100000001
1001011111111102100000001
1000000000000000100000001
1001101111111111100000001
1111101111111111111111111
   1101 1
   1111 1