R 960 480

NO ./textures/1.xpm
SO ./textures/178.xpm
EA ./textures/33.xpm
WE ./textures/193.xpm

S ./sprites/446.xpm

F 100,100,100
C 150,150,150

1111111111111111111111111
1000000000000000000000001
100N000000100000000000001
1000000000000000000000001
1000000000000002000000001
1000000000000000000000001
1000000000000000000000001
1000000000000000000000001
1000000000000001000000001
1000000000000000000000001
1000000000000000000000001
1000000000000000000000001
1000000000000000000000001
1000000000000000000000001
1000000000000000000000001
1000000000000000000000001
1000000000000000000000001
1000000000000000000000001
1111111111111111111111111
